> > > > > > > v < <
> > > > > > > X < <
> > > > ^ ^ ^ ^ ^ ^
^ > > ^ ^ ^ ^ ^ < ^
^ ^ ^ ^ ^ ^ > ^ < ^
^ ^ ^ ^ ^ ^ > ^ ^ ^
^ ^ ^ ^ ^ ^ ^ ^ < <
^ < > > ^ ^ ^ ^ ^ ^
^ > > > ^ ^ ^ ^ < ^
^ > > ^ ^ < < < < <
