> > > > > > > X < <
> > > > > > ^ ^ ^ ^
^ > > ^ ^ ^ ^ ^ ^ ^
^ ^ ^ ^ ^ ^ ^ ^ < ^
^ ^ ^ ^ ^ ^ > ^ < ^
^ ^ ^ ^ ^ ^ < ^ ^ ^
^ ^ ^ ^ ^ ^ ^ ^ < <
^ < > > ^ ^ ^ ^ ^ ^
^ < > > ^ ^ ^ ^ < <
^ > > ^ ^ < < < < <
