My map:
> > > > v < < < < <
> > > > X < < < ^ ^
> > > ^ ^ ^ ^ ^ ^ ^
^ ^ ^ ^ ^ < < v v ^
^ ^ ^ ^ ^ < < v < <
^ ^ ^ ^ ^ < < < < <
^ ^ ^ ^ ^ ^ < < < <
^ < > > ^ ^ ^ ^ < ^
^ < < > ^ ^ < ^ < <
^ < < ^ ^ < < < < <

Standard map:
> > > > v < < < < <
> > > > X < < < < ^
> > > ^ ^ ^ < ^ ^ ^
^ > ^ ^ ^ ^ < ^ < ^
^ ^ ^ ^ ^ < < < < <
^ ^ ^ ^ ^ ^ < < < <
^ ^ ^ ^ ^ ^ < < < <
^ < > > ^ ^ ^ ^ < ^
^ > > ^ ^ ^ < ^ < <
^ > > ^ ^ < < < < <

Mean Score:
[88. 97. 84. 87. 91.]