> > > > > > > > > X
> > > > > ^ ^ ^ ^ ^
^ > > ^ ^ ^ ^ ^ ^ ^
^ ^ ^ ^ ^ ^ ^ ^ > ^
^ ^ ^ ^ ^ < > > ^ ^
^ ^ ^ ^ ^ ^ > ^ ^ ^
^ ^ ^ ^ ^ ^ ^ ^ < <
^ < > > ^ ^ ^ ^ ^ ^
^ < > > ^ ^ ^ ^ < ^
^ < > ^ ^ < < < < <
