> > > > v < < < < <
> > > > X < < < < ^
> > > ^ ^ ^ < ^ ^ ^
^ > ^ ^ ^ ^ < ^ < ^
^ ^ ^ ^ ^ < < < < <
^ ^ ^ ^ ^ ^ < < < <
^ ^ ^ ^ ^ ^ < < < <
^ < > > ^ ^ ^ ^ < ^
^ > > ^ ^ ^ < ^ < <
^ > > ^ ^ < < < < <
