My map:
> > > > > > > > > X
> > > > ^ ^ ^ ^ ^ ^
^ > ^ ^ ^ ^ ^ ^ ^ ^
^ ^ ^ ^ ^ ^ ^ ^ > ^
^ ^ ^ ^ ^ < < v < ^
^ ^ ^ ^ ^ < < < < ^
^ ^ ^ ^ ^ ^ < < < <
^ < > > ^ ^ ^ ^ < ^
^ < < > ^ ^ < ^ < <
^ < < ^ ^ < < < < <

Standard map:
> > > > > > > > > X
> > > > > ^ ^ ^ ^ ^
^ > > ^ ^ ^ ^ ^ ^ ^
^ ^ ^ ^ ^ ^ ^ ^ > ^
^ ^ ^ ^ ^ < > > ^ ^
^ ^ ^ ^ ^ ^ > ^ ^ ^
^ ^ ^ ^ ^ ^ ^ ^ < <
^ < > > ^ ^ ^ ^ ^ ^
^ < > > ^ ^ ^ ^ < ^
^ < > ^ ^ < < < < <

Mean Score:
[88. 97. 84. 87. 91.]